NO ./images/NO.xpm
SO ./images/SO.xpm
WE ./images/WE.xpm
EA ./images/EA.xpm
F 110,153,15
C 255,255,255
        1111111111111111111111111
        1000000000000000000000001
        1100000000000000000000001
        1000000000000000000000001
111111111000000000000000000000001
1000000000000000E0000000000001111
100000000000000000000000000010000
100000000000000000000000000010000
100000000000000000000000000010000
100000000000000000000000000010000
100000000000000000010100000010000
110000011101010111110111101010000
11110111 1110111 1011110100010000
11111111 1111111 1111111111110000
