
WE ./sprites/barrel.png

F 255,100,0
SO ./sprites/barrel.png

NO ./sprites/barrel.png
EA ./sprites/barrel.png
C 225,30,0

11111
10N01
1   1
10001
11111