
WE ./sprites/barrel.png

F 255,100,0
SO ./sprites/barrel.png

NO ./sprites/barrel.png
EA ./sprites/barrel.png
C 225,30,0


        111111111111111111111111111111111111111111111111111111111111111111
        100000000011000000000000                                         11111111
        101100000111000000100001                                                1
        1001000000000000000000001                                               1
111111111011000001110000000000001                                               1
000000000011000001111011111111111                                               1
11110111111111011100000010001                                                   1
11110111111111011101010010001                                                   1
11000000110101011100000000001                                                   1
10000000000000001100000010001             E                                     1
10000000000000001101010010001                                                   1
11000001110101011111011110 0111                                                 1
11110111 1110101 10111110001                                                   1
11111111 1111111 1111111111111111111111111111111111111111111111111111111111111111


